wwwwwwwwwwwwwwwwwwww
w............54....w
w..................w
w.....A.......1....w
w..1..........4....w
w..........1.......w
w.....1............w
w..................w
w.......5..........w
w..................w
w.4................w
w.....1.....g......w
w...........4......w
w..............5...w
w..................w
w..................w
w..................w
w....4.............w
w4.................w
wwwwwwwwwwwwwwwwwwww
